**************************
******------------*------*
******------------D------*
*----*------------*------*
*----*------------*------*
*----*------------********
****D*-------------------*
-------------------------*

