********S*****************
******------------*------*
******-------------------*
*----*------------*------*
*----*------------*------*
*----*------------********
****-*------------------S*
-------------------------*